{
  "processed_ids": [
    "23674",
    "13122",
    "19276",
    "29318",
    "20187",
    "25002",
    "29406",
    "18882",
    "27910",
    "25897",
    "14926",
    "12136",
    "13460",
    "16802",
    "15804",
    "15805",
    "23798",
    "11760",
    "25240",
    "25447",
    "11822",
    "13206",
    "23009",
    "19356",
    "28009",
    "21838",
    "26654",
    "16340",
    "22394",
    "27110",
    "26726",
    "19006",
    "29628",
    "25484",
    "19446",
    "27144",
    "12964",
    "28401",
    "21444",
    "12896",
    "22072",
    "23198",
    "11292",
    "15917",
    "13616",
    "22050",
    "22821",
    "26204",
    "11881",
    "24738",
    "27330",
    "20274",
    "22148",
    "24720",
    "14164",
    "12254",
    "16420",
    "16507",
    "25176",
    "14149",
    "25528",
    "19984",
    "25765",
    "22630",
    "26386",
    "16506",
    "28400",
    "23799",
    "22820",
    "22631",
    "21998",
    "23008",
    "26344",
    "11118",
    "29550",
    "20488",
    "15933",
    "23176",
    "16195",
    "20776"
  ],
  "last_index": 80,
  "total_activities": 1164189
}